0011111210102011
0022022201010000
2020200000000200
0020002102200000
0020002102000001
0022222222000110
0100100120010000
0000000020201010
2220110100000112
0221200222201101
0000022002011111
0002200001111111