22222222222222222222222222222222222222222222222222
20000000000000000000000000000000000000000000000002
20000000003333333333330000000000000000000000000002
20000000003333333333330000000000000000000000000002
20000000003333333333330000000000000000000000000002
20000000003333333333330000000000000000000000000002
20000011111111111111111111110000000000000000000002
20000011111111111111111111110000000000000000000002
20000011111111111111111111110000000000000000000002
20000011111111111111111111110000000000000000000002
20000011111111111111111111110000000000000000000002
20000011111111111111111111110000000000000000000002
20000000000000000000000000000000000000000000000002
20000000000000000000000000000000000000000000000002
20000000044444444444440000000000000000000000000002
20000000044444444444440000000000000000000000000002
20000000044444444444440000000000000000000000000002
20000000044444444444440000000000000000000000000002
20000000044444444444440000000000000000000000000002
20000000000000000000000000000000000000000000000002
20000000000000000000000000000000000000000000000002
20000000000000055555555555555555500000000000000002
20000000000000055555555555555555500000000000000002
20000000000000055555555555555555500000000000000002
20000000000000055555555555555555500000000000000002
20000000000000055555555555555555500000000000000002
20000000000000055555555555555555500000000000000002
20000000000000000000000000000000000000000000000002
20000000000000000000000000000000000000000000000002
20000000000000000000000000000000000000000000000002
20000000000000000000000000000000000000000000000002
20000000000000000000000000000000000000000000000002
20000000000000000000000000000000000000000000000002
20000000000000000000000000000000000000000000000002
20000000000000000000000000000000000000000000000002
20000000000000333333333300000000000000000000000002
20000000000000333333333300000000000000000000000002
20000000000000333333333300000000000000000000000002
20000000000000333333333300000000000000000000000002
20000000000000000000000000000000000000000000000002
20000000000000000000000000000000000000000000000002
20000000044444444000000000000000000000000000000002
20000000044444444000000000000000000000000000000002
20000000044444444000000000000000000000000000000002
20000000044444444000000000000000000000000000000002
20000000000000000000000000000000000000000000000002
20000000000005555555500000000000000000000000000002
20000000000005555555500000000000000000000000000002
20000000000005555555500000000000000000000000000002
20000000000000000000000000000000000000000000000002
22222222222222222222222222222222222222222222222222
